MAP 15 16
################
#      X       #
# ############ #
# #     o      #
# # ########## #
# # #        # #
# # # ###### # #
P            o +
## #### ###### #
#     # #o   # #
#     # #### # #
#            # #
#     #      # #
#     #       X#
################
SWITCH 0 3
PLAYER 0 7
ENEMY X 7 1 none 0 0 0 0 
ENEMY X 14 13 none 0 0 0 0